አራን (Aaron) - ደግሞም መለያዬ ነው; መለያ; ጥቅም ተናዛው
አባዶን (Abaddon) - ሰውነትን በማሳደር; አጠገምት
አባግታ (Abagtha) - የጮል ማጥጫ የአይተር
አባና (Abana) - ስምንት ተገልጧል; ጆሮ
አባሪም (Abarim) - ተመረጠባቸው; በቀላሉ ጉዞዎቻቸው
አባ (Abba) - አባ
አብዳ (Abda) - አባት; ገዥዎች
አብደኤል (Abdeel) - ምዕራፍ; እንደእራስ እንደሚያሳስ
አብድኤል (Abdi) - አባትዋ
አብድይኤል (Abdiel) - አባት መስቀል
አብዶን (Abdon) - አባት; የአጥብቀስ ጉዞ
አበድነጎ (Abednego) - አባት መጥፋት; የምትዋጅ
አቤል (Abel) - የማያልቅ; የምትያዝም; ምንት; ድርቀት
አቤል (Abel) - አንድ ከተማ; የምትረዝመም
አቤል-ቤት-መአማቻ (Abel-beth-maachah) - የማህያት ሥጋ ወደ የማአራቻ ሠራተኞች
አቤል-መዓኮን (Abel-maim) - የባህር ሥጋ ወደ ውኃ
አቤል-መሆላ (Abel-meholah) - የባህር ሥጋ ወደ መሆላ
አቤል-መግሬድ (Abel-mizraim) - የኢጣልት ሥጋ ወደ ሜትሬድ
አቤል-ሽትትም (Abel-shittim) - የማህር ሥጋ ወደ ተረባሽ
አቤዝ (Abez) - የብርሃን; ጦጣቸው
አቢ (Abi) - አባቴ
አቢያ (Abiah) - ሥራ አባቴ ነው
አቢ-አልቦን (Abi-albon) - አባት መረጠቴ
አቢዓሣፍ (Abiasaph) - አባት የጠናዳቸው; የተረጋማው
አቢየር (Abiathar) - የአባት ምልክት; የአባት ምልክት የሚያቀልጠው
አብብ (Abib) - የአባት እርሻ; ተለያዩ የሆሻቸው
አብዳ (Abidah) - እርሻ የአስተዳደር
አቢዳል (Abidan) - እርሻ የምልክት
አቢኤል (Abiel) - እግዚአብሔር የአባት ምልክት
አቢይዎስ (Abiezer) - የአባት እስትኝ
አቢጌል (Abigail) - የአባት ቅምት
አቢሀይሉ (Abihail) - የአባት እግዚአብሔር የአባት እግር
አቢየህል (Abihu) - የአባት ሰይጣን
አቢሁድ (Abihud) - የአባት መልክት; ሕዝብ የተዋጅበት
አቢጃ (Abijah) - የአባት መልክት
አቢይሕ (Abijam) - የአባት መዳረሻ
አቢሌነ (Abilene) - የአባት ሕዝብና የማህሌት
አመውኣ (Abimael) - የአባት መረጃ ከጌባ ተራራ በመግመር ላይ
አቢሜሌክ (Abimelech) - የአባት ህዝብ
አቢናድ (Abinadab) - የአባት ምልክት ወደ ውኃው፣ ወደ ሀዝና ወደ መሥርዓት
አቢየስፍ (Abinoam) - የአባት ቅርንዓት
አቢራም (Abiram) - የአባት ተመንቀቅ; የአባት ሙከራ
አቢስሐግ (Abishag) - አባትዋ የምትማስጠንቀቅ
አቢሴው (Abishai) - አባትዋ የማትማስጠንቀቅ
አቢሻሎም (Abishalom) - አባትዋ የማትማስጠንቀቅ
አቢሹኣ (Abishua) - አባትዋ የመልክት
አቢሹር (Abishur) - አባትዋ የጥቁልቅድ
አቢጠል (Abital) - አባትዋ የምትርገዝ; የምትሳም
አቢዙብ (Abitub) - አባትዋ የመገዝን
አቢዩድ (Abiud) - አባትዋ የምሽመው የአባት ምልክት
አብነር (Abner) - አባትዋ የመለያ
አብራም (Abram) - አባት የአምስት ገንዘብ